b	不 边 把 白 别 部 八 般 宝 帮 巴
c	出 除 成 从 此 次 参 穿 称 差 初
d	的 对 大 得 当 道 代 党 答 单 刀
f	发 飞 夫 分 非 方 妇 福 范 富 翻
g	个 给 过 公 国 高 敢 观 官 规 广
h	和 好 还 会 回 话 乎 坏 欢 黄 怀
j	就 经 进 几 见 家 教 剑 江 计 交
k	可 孔 开 看 口 快 库 款 宽 括 亏
l	了 力 来 利 里 立 李 领 流 令 离
m	没 民 面 名 明 门 眉 猛 毛 梅 买
n	你 那 南 年 内 农 纳 凝 奶 闹 奈
p	平 皮 破 片 品 怕 牌 判 凭 匹 骗
q	去 强 起 全 且 前 青 求 请 奇 期
r	人 如 若 然 日 让 惹 刃 润 儒 扔
s	是 双 事 手 上 说 市 世 师 思 设
t	他 她 天 体 同 头 叹 唐 跳 脱 逃
v	而 阿 二 儿 暗 安 傲 艾 埃 哀 澳
w	我 维 无 外 晚 为 闻 威 温 围 忘
x	下 线 想 笑 小 心 形 息 喜 香 兴
y	一 也 有 用 眼 意 元 远 玉 影 语
z	在 子 正 自 中 着 指 资 字 坐 掌
ba	报 吧 保 办 半 百 包 抱 班 板 败
be	本 被 北 备 背 辈 奔 杯 贝 悲 臂
bi	便 并 表 比 必 变 标 兵 病 冰 避
bo	波 博 播 拨 勃 伯 搏 薄 脖 玻 驳
bu	步 布 补 堡 捕 卜 怖 簿 哺 埠 卟
ca	才 长 场 产 常 查 察 草 财 超 藏
ce	车 程 城 沉 曾 陈 承 层 策 测 侧
ci	吃 持 刺 词 迟 尺 赤 辞 池 痴 慈
co	重 冲 充 仇 抽 匆 聪 愁 丑 筹 丛
cu	处 传 错 楚 村 存 创 春 船 床 窗
da	到 但 打 带 倒 达 待 导 担 淡 丹
de	等 德 登 灯 瞪 邓 凳 蹬 镫 噔 磴
di	第 地 点 定 电 弟 低 底 敌 掉 顶
do	动 东 斗 洞 懂 抖 冬 董 豆 陡 逗
du	多 都 度 队 断 段 毒 独 顿 端 短
fa	法 放 反 房 防 访 饭 凡 犯 烦 仿
fe	风 费 份 凤 封 峰 纷 奋 丰 奉 疯
fi	付 附 扶 呋 咈 噃
fo	否 佛 缶 仏 坲 梻 紑 缹 缻 鴀 芣
fu	服 父 府 复 副 负 伏 扶 附 符 抚
ga	感 该 干 告 改 刚 赶 港 概 盖 搞
ge	更 各 跟 哥 根 格 革 歌 隔 阁 葛
gi	古 咕 嘎 呱 哽 呷
go	工 功 共 够 宫 构 供 攻 狗 购 勾
gu	关 光 果 管 怪 姑 故 顾 鬼 贵 股
ha	海 孩 害 汉 哈 寒 号 毫 含 韩 喊
he	很 何 合 黑 喝 河 恨 横 哼 狠 核
hi	护 怀 呵 嗨 嗬 呼
ho	后 红 候 厚 洪 侯 吼 宏 虹 轰 喉
hu	化 花 活 华 火 或 环 呼 湖 缓 户
ja	将 间 加 叫 建 件 脚 较 讲 坚 角
je	接 解 结 界 姐 节 杰 街 介 借 阶
ji	己 机 今 金 记 及 近 济 惊 即 极
jo	炯 窘 迥 扃 炅 幜 冋 坰 埛 絅 駉
ju	决 军 据 觉 绝 举 局 句 居 具 君
ka	考 靠 康 卡 抗 凯 刊 堪 砍 慨 咖
ke	科 克 刻 客 肯 颗 课 柯 渴 咳 棵
ki	扩 咯 咔 哐 嘅 咖
ko	空 恐 控 寇 扣 叩 崆 蔻 抠 倥 箜
ku	苦 况 块 狂 困 哭 跨 昆 阔 愧 酷
la	老 拉 兰 啦 劳 蓝 浪 郎 朗 莱 狼
le	冷 乐 类 雷 泪 累 勒 愣 蕾 磊 楞
li	两 理 连 脸 林 量 留 联 六 另 灵
lo	龙 楼 露 隆 笼 漏 搂 拢 陋 咙 胧
lu	路 论 落 罗 乱 律 略 率 陆 绿 洛
ma	马 吗 满 忙 妈 慢 麻 卖 贸 冒 骂
me	梦 每 美 么 妹 们 蒙 孟 盟 闷 媚
mi	命 密 免 米 迷 秘 妙 灭 敏 描 鸣
mo	模 莫 魔 某 默 摸 谋 眸 摩 末 漠
mu	目 母 木 慕 幕 姆 穆 牧 亩 墓 沐
na	难 哪 男 拿 脑 乃 耐 喃 恼 囊 衲
ne	能 呢 嫩 讷 恁 馁 呐 竜 倷 抐 訥
ni	娘 念 您 尼 宁 牛 鸟 妮 泥 扭 聂
no	弄 浓 哝 侬 脓 耨 莀 衖 鬞 秾 農
nu	女 怒 努 诺 奴 娜 暖 挪 虐 弩 懦
pa	派 旁 跑 排 拍 盘 爬 庞 袍 胖 抛
pe	朋 配 碰 陪 培 佩 鹏 喷 捧 彭 裴
pi	批 评 偏 贫 飘 票 拼 篇 漂 劈 频
po	婆 迫 颇 坡 魄 泼 剖 珀 泊 鄱 叵
pu	普 扑 仆 铺 朴 蒲 谱 葡 浦 噗 菩
qa	千 钱 瞧 巧 抢 墙 枪 乔 悄 桥 潜
qe	切 怯 妾 窃 茄 惬 锲 挈 箧 郄 趄
qi	情 气 其 轻 清 亲 企 七 器 齐 秋
qo	穷 琼 穹 邛 茕 蛩 筇 跫 銎 輁 棾
qu	却 区 取 确 群 权 曲 拳 趣 缺 屈
ra	绕 染 扰 燃 饶 嚷 冉 髯 壤 攘 娆
re	任 认 仍 热 忍 仁 韧 仞 纫 荏 饪
ri	驲 囸 釰 鈤 馹
ro	容 柔 肉 荣 融 蓉 揉 绒 溶 冗 戎
ru	入 软 弱 瑞 辱 锐 阮 乳 汝 芮 茹
sa	三 少 山 杀 伤 商 尚 闪 沙 赛 善
se	生 身 声 谁 神 色 社 深 什 甚 省
si	时 实 十 使 死 四 斯 似 石 失 式
so	受 收 首 送 守 松 宋 授 售 瘦 搜
su	所 水 数 算 书 虽 术 随 诉 树 速
ta	太 它 谈 台 态 堂 讨 探 抬 套 塔
te	特 腾 疼 藤 滕 忑 忒 誊 慝 铽 貣
ti	听 提 题 条 铁 停 田 替 调 厅 挑
to	通 统 痛 投 透 偷 童 铜 桐 筒 桶
tu	突 图 推 团 退 土 托 徒 腿 途 吐
va	爱 啊 案 按 奥 岸 呆 唉 昂 碍 矮
ve	尔 耳 恩 恶 额 俄 愕 饿 峨 呃 厄
vi	嗯 诶 哎 唔 嗷 嗄
vo	欧 哦 偶 喔 噢 呕 殴 鸥 藕 讴 耦
vu	癌 昂 碍 挨 俺 黯
wa	望 王 万 往 完 网 玩 亡 瓦 湾 娃
we	问 文 位 未 微 委 卫 味 危 伟 唯
wi	稳 味 呜 喔 喂 吻
wo	握 卧 窝 沃 涡 渥 倭 挝 斡 蜗 龌
wu	五 务 武 物 屋 舞 午 吴 误 乌 伍
xa	现 向 相 先 像 象 消 项 响 显 效
xe	些 谢 写 协 血 邪 斜 鞋 胁 歇 泄
xi	行 新 信 西 性 系 星 希 细 型 修
xo	兄 雄 胸 凶 熊 汹 匈 芎 焸 赨 兇
xu	学 许 须 选 需 雪 续 寻 宣 徐 虚
ya	要 样 言 阳 亚 严 摇 研 药 杨 扬
ye	业 夜 爷 叶 野 页 耶 液 冶 曳 谒
yi	以 已 因 应 衣 义 音 议 英 易 引
yo	又 由 友 右 游 优 永 油 尤 拥 勇
yu	于 与 月 原 云 员 院 运 约 越 愿
za	再 展 张 找 早 咱 站 招 照 造 丈
ze	这 真 者 怎 政 则 整 阵 增 证 争
zi	之 只 知 直 制 至 治 志 支 质 止
zo	走 种 总 众 周 终 州 钟 纵 洲 宗
zu	作 主 住 最 做 转 组 足 准 注 左
bb	并不 半边 本报 不便 宝贝 不必 报表 宝宝 爸爸 不变
bc	不错 奔驰 变成 报仇 彼此 不曾 编程 保持 补充 保存
bd	不断 部队 表达 不但 宝典 报道 不定 必定 半岛 拔掉
bf	办法 不妨 冰封 步伐 并非 北方 报复 播放 备份 爆发
bg	罢工 不敢 不顾 不管 宝贵 不该 变更 报告 不够 办公
bh	保护 办好 变换 变化 编号 北海 便会 背后 包含 百货
bj	北京 巴结 不禁 不仅 背景 毕竟 不解 不久 比较 不及
bk	不肯 鼻孔 包括 本科 被困 博客 报考 避开 不堪 板块
bl	本来 罢了 不理 巴黎 变量 不论 办理 不料 本领 玻璃
bm	罢免 不妙 表面 避免 表明 不满 版面 不免 帮忙 保密
bn	半年 不能 别扭 百年 保暖 不宁 帮您 帮你 不难 本能
bp	被迫 被骗 编排 本片 本品 背叛 变频 奔跑 被判 帮派
bq	表情 百强 版权 标签 并且 不清 本期 兵器 比起 抱歉
br	必然 不忍 般若 本人 本日 不容 薄弱 病人 比如 被人
bs	表示 本书 办事 本身 不少 比赛 部署 不时 半晌 博士
bt	半天 不通 不太 摆脱 标题 把它 补贴 本帖 不停 变态
bv	备案 贝阿 北欧 不爱 彼岸 保安 本案 悲哀 比尔 贝尔
bw	把握 保卫 百万 帮我 本网 不问 包围 本文 部位 比我
bx	必须 保险 表现 不行 不虚 不许 百姓 不幸 八仙 不限
by	不要 不已 必要 本月 不易 表演 不由 毕业 本页 不愿
bz	不住 保障 不再 部长 帮助 保证 不止 标准 不足 不准
cb	出版 承办 成本 苍白 初步 传遍 储备 传播 差别 翅膀
cc	常常 传出 尺寸 匆匆 虫虫 层次 处处 财产 长长 抽出
cd	程度 车队 颤抖 吃得 差点 彻底 长度 承担 冲动 成都
cf	充分 长发 查封 吃饭 处罚 厨房 厂房 采访 重复 财富
cg	成功 参观 超过 持股 成果 超高 常规 采购 错过 唱歌
ch	窗户 才好 策划 才会 称呼 仇恨 彩虹 称号 场合 此后
cj	参加 曾经 促进 长久 常见 吃惊 此间 长剑 成绩 刺激
ck	此刻 诚恳 参考 查看 窗口 仓库 刺客 存款 残酷 乘客
cl	处理 吃了 传来 彩铃 策略 材料 灿烂 产量 车辆 测量
cm	充满 村民 场面 驰名 聪明 车门 出卖 沉默 传媒 层面
cn	才能 超女 嘲弄 菜鸟 车内 承诺 城内 常年 处女 产能
cp	产品 彩屏 彩票 唱片 超频 裁判 草坪 磁盘 测评 诚聘
cq	采取 超强 长期 春秋 插曲 重庆 拆迁 产权 传奇 初期
cr	承认 脆弱 耻辱 仇人 春日 从容 出任 插入 残忍 超人
cs	此时 纯属 传输 产生 才是 城市 参数 措施 测试 沉思
ct	传统 出台 餐厅 朝廷 长叹 冲突 成套 春天 长途 此贴
cv	长安 嫦娥 尘埃 宠爱 此岸 草案 超额 此案 初二 刺耳
cw	从未 创维 初五 窗外 春晚 错误 传闻 称为 财务 宠物
cx	出现 持续 呈现 朝鲜 晨曦 程序 成效 重新 出席 创新
cy	产业 诧异 参与 采用 成员 创意 草原 沉吟 处于 迟疑
cz	存在 车子 财政 操作 初中 穿着 城镇 创造 沉重 创作
db	代表 躲避 打扮 担保 地步 大半 对比 大步 多半 东北
dc	调查 单纯 达成 到处 点此 当初 地产 多次 当场 低沉
dd	得到 导弹 达到 等待 地点 到底 懂得 地道 淡淡 当地
df	地方 打发 颠覆 对付 大幅 东方 多方 到访 东风 答复
dg	大哥 大纲 大概 多个 德国 蛋糕 点歌 灯光 帝国 东莞
dh	电话 多好 动画 都会 带回 大汉 大海 等候 导航 得很
dj	多久 大局 打击 当今 大叫 东京 等级 代价 动静 登记
dk	打开 打孔 贷款 都看 端口 带宽 大哭 对抗 抵抗 都快
dl	带来 大陆 道理 带领 大量 独立 到了 道路 打量 到来
dm	多么 大马 地面 多名 东盟 动漫 店面 代码 都没 倒霉
dn	多年 都能 东南 电脑 党内 大闹 但你 到你 到您 等你
dp	大批 肚皮 打破 大盘 毒品 点评 跌破 搭配 店铺 短片
dq	地区 党群 的确 的钱 电器 道歉 短期 地球 定期 对其
dr	敌人 刀刃 打扰 担任 冬日 点燃 登入 动人 陡然 等人
ds	但是 读书 低声 打算 多少 电视 动手 当时 地上 大师
dt	点头 电台 动态 独特 打听 低头 大厅 地图 但他 冬天
dv	第二 窦娥 东欧 点儿 对啊 答案 德尔 档案 戴尔 定额
dw	单位 大卫 第五 地位 电网 耽误 到我 队伍 党委 动物
dx	东西 短线 地下 对象 弟兄 担心 大喜 大学 大型 底下
dy	第一 大约 对于 地狱 电影 答应 得以 定义 党员 等于
dz	弟子 肚子 当真 动作 得罪 带着 多种 斗争 读者 电子
fb	发表 反驳 分布 方便 腐败 封闭 风波 发布 风暴 法宝
fc	非常 付出 方才 风采 发财 房产 服从 扶持 放出 飞船
fd	反对 辅导 负担 非但 非典 奋斗 发达 发动 饭店 发抖
ff	方法 纷纷 防范 仿佛 吩咐 丰富 复发 夫妇 非法 反复
fg	法国 分隔 放过 分管 风光 覆盖 发光 法规 风格 分割
fh	发挥 粉红 防护 符合 返回 复活 废话 复合 凤凰 符号
fj	房间 福建 飞机 附近 风景 发觉 佛教 分解 附件 房价
fk	放开 复垦 反抗 疯狂 封口 访客 妇科 付款 反馈 罚款
fl	法律 翻了 飞龙 福利 房里 分类 泛滥 分离 风流 分裂
fm	父母 分娩 封面 风貌 仿冒 房门 分泌 丰满 抚摸 负面
fn	妇女 愤怒 抚弄 飞鸟 房内 烦恼 发难 方能 发怒 父女
fp	分配 放屁 发票 扶贫 废品 反叛 富婆 肥胖 复牌 分批
fq	父亲 奉劝 夫妻 风气 分歧 放弃 扶起 风情 分区 番茄
fr	妇人 缝纫 繁荣 法人 肥肉 否认 凡人 芙蓉 放入 发热
fs	发生 附属 方式 翻身 凡是 发送 服饰 放松 发誓 放手
ft	发帖 反弹 封套 繁体 发贴 法庭 风头 附图 丰田 访谈
fv	反而 份额 妨碍 菲尔 飞蛾 方案 份儿 法案 风儿 肺癌
fw	服务 房屋 发威 飞舞 范围 访问 绯闻 氛围 风味 富翁
fx	发现 风险 分析 方向 反响 放心 分享 放下 发行 奉献
fy	反应 法院 飞扬 费用 反映 发言 房源 富有 翻译 风云
fz	发展 房子 负责 分钟 否则 非洲 法子 反正 复杂 犯罪
gb	根本 改编 公布 官兵 告别 干部 更不 改变 广播 关闭
gc	工程 高层 刚才 过程 歌唱 观察 工厂 贯彻 构成 干脆
gd	感到 宫殿 广大 孤独 观点 规定 广东 各地 高度 赶到
gf	功夫 国防 规范 股份 高峰 广泛 辜负 工夫 官方 购房
gg	改革 更改 哥哥 各个 刚刚 古怪 尴尬 各国 格格 广告
gh	规划 搞好 更换 过后 光辉 关怀 光滑 刚好 更好 工会
gj	国际 更加 根据 关键 工具 感觉 赶紧 各级 感激 攻击
gk	赶快 管孔 高考 观看 港口 顾客 概况 广阔 更快 过客
gl	管理 功力 鼓励 规律 公路 各类 桂林 光临 攻略 功率
gm	革命 购买 规模 改名 光明 歌迷 哥们 光芒 感冒 干嘛
gn	姑娘 功能 赣南 观念 供暖 工农 归纳 概念 给您 跟你
gp	股票 滚屏 古朴 光盘 高频 各派 果品 挂牌 该片 攻破
gq	感情 光驱 供求 国企 歌曲 跟前 国庆 敢情 股权 钢琴
gr	果然 刚柔 光荣 工人 骨肉 感染 公认 怪人 固然 各人
gs	告诉 公司 故事 感受 更是 改善 攻势 高速 工商 高声
gt	共同 沟通 国土 钢铁 感叹 骨头 跟贴 跟他 港台 跟她
gv	关爱 关隘 故而 孤儿 感恩 港澳 格尔 个案 高昂 高额
gw	各位 恭维 国王 怪物 官网 更为 改为 岗位 购物 顾问
gx	关系 光线 阁下 购销 功勋 高兴 甘心 关心 贡献 感谢
gy	关于 给予 给予 共有 共用 工业 故意 工艺 官员 过于 怪异
gz	工作 故障 果真 各种 规则 跟着 关注 公主 各自 改造
hb	毫不 回避 回报 伙伴 河北 何必 合并 货币 环保 湖北
hc	何处 画出 火车 好处 好吃 缓冲 换成 合成 很长 缓存
hd	活动 混蛋 回到 回答 蝴蝶 皇帝 好多 很多 获得 忽地
hf	恢复 花费 回覆 回复 横幅 合法 哈佛 合肥 划分 护肤
hg	回归 宏观 回顾 换个 韩国 很高 海关 后果 火光 化工
hh	缓缓 很好 绘画 狠狠 哈哈 后悔 呼唤 嘿嘿 呵呵 黄河
hj	环境 韩剧 环节 黄金 罕见 喝酒 火箭 伙计 好久 痕迹
hk	很快 汗孔 汇款 回馈 户口 何况 贺卡 航空 黑客 海口
hl	后来 活力 合理 混乱 喉咙 婚礼 护理 欢乐 含量 怀里
hm	后面 黑马 号码 毫秒 好吗 昏迷 皇马 画面 缓慢 毫米
hn	河南 很难 湖南 怀念 回暖 胡闹 好难 还能 海南 华南
hp	害怕 黑屏 琥珀 魂魄 货品 好评 划破 活泼 惠普 湖泊
hq	好奇 很强 获取 花钱 火器 行情 华侨 环球 后期 后勤
hr	忽然 环绕 火热 华人 韩日 红润 湖人 坏人 黑人 赫然
hs	和尚 回收 华硕 浑身 皇上 函数 好似 或是 黑色 何时
ht	会谈 后退 航天 话筒 话题 糊涂 海滩 合同 回帖 后台
hv	黑暗 姮娥 和蔼 海尔 好啊 毫安 孩儿 花儿 海岸 昏暗
hw	毫无 后卫 好玩 海外 回味 化为 华为 户外 货物 还未
hx	或许 和弦 互相 好像 呼吸 核心 化学 含笑 欢喜 好些
hy	会议 何以 还要 怀疑 行业 回忆 火焰 欢迎 花园 婚姻
hz	孩子 汉子 或者 合作 怀中 汉字 活着 胡子 会长 杭州
jb	基本 举办 绝不 肩膀 脚步 疾病 具备 决不 进步 级别
jc	基础 基层 坚持 进程 经常 警察 继承 检查 接触 决策
jd	觉得 绝对 见到 记得 监督 决定 军队 简单 巨大 激动
jf	解放 经费 姐夫 肌肤 绝非 警方 机房 积分 减肥 纠纷
jg	结果 交给 结构 尽管 金刚 机关 军官 机构 价格 警告
jh	几乎 结婚 计划 机会 惊呼 江湖 交换 结合 家伙 讲话
jj	经济 拒绝 积极 接近 紧紧 解决 坚决 究竟 渐渐 姐姐
jk	加快 祭孔 解开 紧靠 接口 健康 监控 尽快 剑客 艰苦
jl	建立 极了 将来 纪律 尽量 距离 角落 交流 经历 激烈
jm	急忙 居民 局面 经贸 节目 寂寞 加密 紧密 界面 加盟
jn	今年 艰难 江南 近年 境内 拘泥 节能 纪念 技能 就能
jp	金牌 精辟 机票 键盘 精品 浸泡 敬佩 极品 奖品 就跑
jq	加强 坚强 及其 健全 机器 交情 金钱 举起 极其 惊奇
jr	进入 假如 金融 既然 今日 兼容 惊人 居然 竟然 加入
js	建设 介绍 技术 接受 加上 精神 计算 就算 即使 解释
jt	今天 交通 静态 具体 集团 家庭 简体 集体 肩头 交谈
jv	骄傲 金娥 继而 饥饿 激昂 金额 劲儿 教案 巨额 煎熬
jw	极为 结尾 紧握 交往 今晚 绝望 几位 均为 叫我 较为
jx	进行 继续 脚下 举行 揭晓 决心 惊喜 教训 教学 景象
jy	教育 经验 具有 监狱 就业 建议 加以 就要 经营 基于
jz	记者 紧张 简直 机制 集中 接着 进展 竞争 价值 建筑
kb	恐怖 捆绑 开本 空白 拷贝 看病 快步 开办 快报 课本
kc	考察 扣除 快车 课程 快餐 矿产 堪称 库存 开车 开创
kd	看到 刊登 扩大 口袋 快点 肯定 开店 宽带 快递 可达
kf	开放 刊发 可否 克服 咖啡 看法 狂风 客服 康复 客房
kg	客观 可观 快感 控股 跨国 开关 矿工 可供 开工 考古
kh	客户 科幻 考核 抗衡 口号 快活 恐慌 抗洪 困惑 开户
kj	科技 框架 抗拒 靠近 盔甲 空间 开机 恐惧 会计 快捷
kk	可靠 开垦 苦苦 科科 空旷 慷慨 刻苦 开阔 空空 宽阔
kl	考虑 刻录 恐龙 快乐 骷髅 可怜 口令 颗粒 可乐 开朗
km	昆明 快马 开幕 科贸 科目 苦闷 开满 楷模 苦命 快慢
kn	可能 困难 柯南 靠你 课内 苦恼 狂怒 苦难 矿难 空难
kp	恐怕 开辟 开拍 卡片 宽频 科普 看盘 开盘 宽屏 考评
kq	口气 跨骑 开枪 客气 况且 开启 口腔 空气 哭泣 块钱
kr	客人 开刃 困扰 狂人 抗日 宽容 跨入 狂热 扩容 烤肉
ks	开始 看书 快速 考生 口水 考试 可使 开设 亏损 款式
kt	客厅 开通 开拓 卡特 课堂 空调 抗体 卡通 课题 可调
kv	可爱 看啊 可按 科尔 口岸 抗癌 靠岸 酷爱 克尔 凯恩
kw	渴望 库娃 可恶 刊物 口味 看完 可望 可谓 课文 看望
kx	科学 空隙 康熙 苦笑 空虚 可惜 可向 可选 快讯 开学
ky	可以 考验 科研 可疑 开业 抗议 跨越 快要 考研 刻意
kz	控制 开展 客栈 可知 空中 靠着 看著 扩展 扩张 夸张
lb	老板 两边 联邦 老爸 类别 脸部 离别 列表 路边 来吧
lc	露出 楼层 立场 流程 理财 两次 流传 临床 列车 凌晨
ld	领导 脸蛋 来到 懒得 来电 力度 老道 劳动 老大 落地
lf	浪费 裂缝 老夫 礼服 力帆 立法 雷锋 来访 疗法 楼房
lg	两国 乐观 掠过 旅馆 牢固 率高 留给 两个 老公 路过
lh	厉害 良好 灵魂 联合 老虎 冷汗 绿化 理会 落后 灵活
lj	立即 邻居 冷静 了解 冷峻 累计 路径 理解 连接 逻辑
lk	离开 脸孔 拉开 理科 路口 立刻 轮廓 凌空 旅客 两款
ll	理论 联络 连连 乐乐 力量 冷冷 流量 来历 凌厉 流露
lm	连忙 罗马 路面 礼貌 联盟 冷漠 流氓 浪漫 栏目 厘米
ln	理念 鲁能 岭南 两年 冷暖 辽宁 靓女 六年 老年 历年
lp	老婆 脸皮 连拍 楼盘 礼品 脸庞 两片 两旁 流派 老牌
lq	离去 李强 乐趣 力气 利器 恋情 冷却 篮球 录取 领取
lr	老人 例如 冷热 两人 落日 利润 猎人 令人 录入 恋人
ls	历史 螺丝 厉声 脸色 路上 落实 老实 立时 粮食 老师
lt	老头 联通 楼梯 两条 聆听 龙头 两天 老天 论坛 聊天
lv	两岸 老媪 老二 恋爱 来啊 立案 怜爱 灵儿 李敖 里奥
lw	另外 螺纹 两万 礼物 联网 论文 列为 来往 两位 例外
lx	冷笑 连续 留下 联系 流星 良心 履行 类型 理想 路线
ly	领域 洛阳 另一 老爷 理由 利益 乐园 旅游 留意 留言
lz	老者 老子 连载 理智 两只 楼主 隆重 拦住 两种 留在
mb	目标 民办 模板 面包 漫步 毛病 模版 面板 弥补 美白
mc	名称 冒出 马车 没错 没吃 每次 门窗 漫长 名词 摩擦
md	目的 摩登 猛地 矛盾 目睹 名单 密度 免得 蓦地 买到
mf	麻烦 免费 密封 埋伏 莫非 魔法 美发 模仿 没法 买房
mg	美国 美观 玫瑰 某个 目光 迷宫 民工 蒙古 每个 敏感
mh	模糊 美好 漫画 幕后 猛虎 门户 民航 梦幻 棉花 迷惑
mj	面积 灭绝 民警 秘籍 模具 民间 秘诀 美军 买家 卖家
mk	模块 毛孔 煤矿 马科 满口 没空 灭口 门槛 麦克 马克
ml	美丽 魅力 忙碌 命令 面临 明亮 魔力 目录 买了 名录
mm	慢慢 妈妈 买卖 面貌 默默 秘密 命名 妹妹 密码 木马
mn	美女 没能 模拟 每年 猛男 木讷 母女 迷你 泌尿 闽南
mp	门派 毛皮 门票 名牌 苗圃 面庞 马屁 马匹 猫扑 买票
mq	目前 勉强 明确 没钱 麻雀 母亲 谋求 密切 煤气 默契
mr	美人 毛绒 闷热 猛然 每日 面容 默认 茫然 迷人 蓦然
ms	马上 秘书 模式 面色 牧师 魔兽 面试 描述 陌生 美食
mt	眉头 每台 每天 媒体 煤炭 码头 漫天 模特 摩托 馒头
mv	名额 母爱 木耳 摩尔 蒙恩 命案 猫儿 木偶 马尔 梅尔
mw	美味 满屋 魔王 每位 每晚 美文 没完 骂我 灭亡 迷惘
mx	模型 冒险 梦想 面向 明显 描写 迷信 某些 明星 慢性
my	美元 绵阳 模样 每月 贸易 满意 民营 命运 面议 每页
mz	名字 帽子 免责 明知 满足 民族 每周 民主 妹子 盟主
nb	宁波 泥巴 能把 那般 南北 脑部 那帮 能不 您不 年报
nc	农村 拿出 内存 昵称 南昌 年初 那场 年产 农场 内测
nd	难道 您对 内地 年代 难点 年度 难度 脑袋 难得 您的
nf	能否 内附 农副 年份 那幅 奶粉 难分 那份 女方 男方
ng	能够 能给 难过 哪个 你跟 难怪 能干 内功 南宫 那股
nh	女孩 男孩 浓厚 年华 呐喊 怒火 农户 脑海 您好 内涵
nj	年纪 年级 宁静 脑筋 你叫 南京 您将 年间 凝聚 你将
nk	难看 农垦 宁可 能看 那颗 内裤 尼克 尼康 那块 内科
nl	努力 能力 拿来 男篮 哪里 女郎 奴隶 年龄 能量 南路
nm	你们 你妈 内幕 那么 你吗 纳米 南美 难免 匿名 纳闷
nn	男女 奶奶 能耐 奶牛 喃喃 南宁 您能 你能 牛奶 你呢
np	哪怕 牛皮 女排 涅盘 尿频 奶瓶 女仆 牛排 内屏 男排
nq	年轻 那群 拿起 怒气 扭曲 弄清 拿钱 你却 拿去 暖气
nr	女人 懦弱 耐热 男人 牛肉 内容 嗫嚅 能让 纳入 难忍
ns	那时 浓缩 女士 难受 乃是 凝视 女声 女生 您是 男生
nt	念头 南通 泥土 那条 难题 扭头 难逃 你听 哪天 你太
nv	女儿 诺阿 难熬 哪儿 你啊 纽澳 尼尔 你爱 鸟儿 男儿
nw	那位 女娲 女王 哪位 内网 难忘 女巫 能为 挪威 你问
nx	那些 年限 宁夏 你先 哪些 女性 年薪 男性 耐心 女星
ny	那样 难以 你要 能用 农业 能源 你又 纽约 女友 内衣
nz	女子 男子 能在 那种 内置 拿着 那只 娘子 脑子 你真
pb	旁边 碰壁 屏蔽 配备 跑步 普遍 评比 疲惫 平板 陪伴
pc	平常 派出 跑车 赔偿 品尝 评测 排出 排除 破产 片长
pd	判断 排队 碰到 平等 盘点 频道 浦东 跑到 庞大 平淡
pf	佩服 批发 牌坊 皮肤 篇幅 配方 排放 平凡 评分 频繁
pg	屁股 旁观 皮革 评估 曝光 偏高 品格 苹果 跑过 飘过
ph	破坏 偏好 破获 配合 批号 平滑 跑回 平衡 排行 徘徊
pj	平静 评级 平均 评价 瞥见 啤酒 判决 配件 破解 凭借
pk	片刻 炮孔 抛开 偏科 贫困 凭空 铺开 盘口 扑克 破空
pl	漂亮 跑了 披露 毗邻 批量 评论 破裂 频率 排列 疲劳
pm	拼命 匹马 屏幕 排名 喷墨 平米 破灭 拍卖 泡沫 媲美
pn	陪你 泡妞 皮囊 骗你 睥睨 叛逆 棚内 凭你 婆娘 排尿
pp	偏偏 屁屁 拍拍 品牌 频频 批评 偏僻 婆婆 匹配 飘飘
pq	脾气 骠骑 跑去 喷泉 派遣 抛弃 片区 聘请 迫切 贫穷
pr	仆人 譬如 疲软 派人 皮肉 漂染 聘任 骗人 旁人 烹饪
ps	平时 评书 拍摄 迫使 爬上 配送 攀升 评审 菩萨 破碎
pt	普通 平台 配套 陪他 陪同 烹调 陪她 葡萄 平坦 拼图
pv	配偶 破案 皮埃 偏爱 佩恩 配额 佩尔 普尔 皮尔 帕尔
pw	颇为 片尾 喷雾 平稳 品味 盼望 评为 陪我 品位 评委
px	培训 拍戏 剖析 评选 咆哮 排序 拍下 平行 皮鞋 平息
py	朋友 濮阳 颇有 飘逸 番禺 培养 评议 便宜 培育 拼音
pz	批准 牌子 碰撞 品种 配置 凭证 膨胀 品质 拍照 骗子
qb	确保 墙壁 情报 骑兵 前辈 七宝 起步 区别 去吧 请把
qc	清楚 取出 汽车 全程 清晨 其次 球场 青春 清除 器材
qd	取得 球队 全都 期待 起点 确定 青岛 强调 启动 渠道
qf	气氛 群发 勤奋 缺乏 岂非 气愤 前锋 欺负 侵犯 清风
qg	奇怪 奇观 情感 七个 求购 器官 千古 情歌 乞丐 牵挂
qh	前后 恰好 切换 强化 漆黑 侵害 奇幻 清华 期货 气候
qj	期间 全局 请教 全集 情景 奇迹 强劲 瞧见 前景 情节
qk	情况 勤恳 期刊 请看 缺口 请客 亲口 乾坤 千克 轻快
ql	强烈 权力 清理 权利 千里 确立 清凉 潜力 情侣 青睐
qm	签名 巧妙 起码 取名 曲目 球迷 骑马 亲密 去买 奇妙
qn	青年 全能 气囊 请您 区内 气恼 岂能 请你 千年 潜能
qp	强迫 欺骗 汽配 亲朋 期盼 气派 切片 全屏 全盘 钦佩
qq	轻轻 牵强 请求 齐全 瞧瞧 悄悄 情趣 亲切 全球 前期
qr	情人 轻柔 亲热 亲人 七日 确认 潜入 悄然 穷人 侵入
qs	其实 全书 轻松 全身 签署 确实 气势 起身 轻声 切实
qt	其他 前台 前提 前途 企图 其它 洽谈 拳头 群体 气体
qv	请按 邱隘 其二 企鹅 去啊 全额 妻儿 去爱 情爱 求爱
qw	千万 前卫 权威 前往 趣味 请问 气味 全文 期望 请勿
qx	情形 情绪 清醒 气息 清晰 取消 缺陷 权限 全新 期限
qy	企业 奇异 区域 其余 轻易 青衣 请与 权益 亲眼 球员
qz	其中 妻子 求职 群众 求助 庆祝 去做 亲自 请在 去找
rb	日本 入编 日报 日版 让步 如冰 人保 热播 人本 仍不
rc	人才 认出 入场 日程 日常 热潮 蠕虫 日产 人称 热忱
rd	认得 荣登 热带 人多 热点 认定 扔掉 瑞典 弱点 入党
rf	乳房 染发 任副 如风 乳峰 燃放 人犯 热风 人防 润肤
rg	如果 人敢 若干 入股 认购 乳沟 软管 人工 人格 绕过
rh	如何 染红 日韩 然后 如虹 润滑 柔和 任何 日后 融合
rj	如今 人际 人均 软件 仍旧 人间 入境 日记 日军 日渐
rk	认可 任课 仍可 仁科 入口 入库 热裤 瑞克 日寇 绕开
rl	人类 热力 热烈 扰乱 容量 燃料 日落 日历 热量 人流
rm	人们 人马 热卖 任命 辱骂 热门 柔美 入门 容貌 如梦
rn	热闹 人能 忍耐 让您 入内 惹恼 任你 容纳 如您 若能
rp	软盘 肉皮 如萍 任凭 乳品 热评 肉票 肉片 肉品 软皮
rq	热情 人群 人权 人气 容器 柔情 人情 日期 入侵 燃气
rr	仍然 容忍 柔软 融入 嚷嚷 认认 惹人 软弱 柔弱 柔柔
rs	认识 人参 人士 人生 仍是 人数 热水 忍受 燃烧 瑞士
rt	认同 融通 热土 软体 如图 让它 任他 肉体 乳头 忍痛
rv	热爱 瑞恩 入耳 仁爱 人啊 乳癌 瑞儿 瑞尔 蓉儿 仍按
rw	认为 柔婉 仍未 任务 入围 人文 入网 人物 日文 融为
rx	热线 柔细 如需 热血 瑞星 入学 热销 热心 人性 人选
ry	人员 人又 仍有 日月 容易 日益 人要 任意 荣誉 日语
rz	认真 入驻 日志 入住 日照 认证 人造 融资 忍者 认知
sb	身边 手臂 上班 设备 失败 生病 顺便 随便 士兵 双臂
sc	市场 伸出 时辰 深处 时常 生产 适才 身材 首次 生成
sd	似的 神殿 受到 时代 闪电 速度 收到 手段 使得 上帝
sf	十分 沙发 是否 师父 山峰 算法 书房 身份 舒服 手法
sg	送给 输给 事故 三个 收购 身高 帅哥 时光 施工 四个
sh	时候 嗜好 深厚 社会 收回 生活 伤害 似乎 身后 上海
sj	时间 世纪 数据 事件 世界 设计 睡觉 实际 书记 实践
sk	时刻 锁孔 思考 收看 伤口 深刻 水库 书库 上课 时空
sl	顺利 实力 树林 胜利 商量 设立 善良 势力 森林 数量
sm	什么 市民 四面 生命 双目 沙漠 数码 神秘 声明 水面
sn	少女 谁能 深南 少年 室内 水泥 四年 首脑 三年 十年
sp	水平 受骗 审批 商铺 商品 身旁 审判 食品 视频 饰品
sq	事情 四强 失去 生气 神器 神情 山区 时期 身躯 死去
sr	虽然 瘦弱 骚扰 收入 生日 湿润 诗人 深入 杀人 死人
ss	身上 税收 收拾 伸手 算是 实施 杀死 事实 神色 受伤
st	身体 使她 生态 尸体 试题 石头 试图 神态 舌头 三天
sv	是啊 山隘 十二 索爱 上岸 数额 涉案 少儿 时而 所爱
sw	所谓 侍卫 尚未 上午 上网 死亡 事物 失望 事务 手腕
sx	实现 视线 思想 首先 师兄 伤心 属性 身形 实行 剩下
sy	所以 实验 所有 使用 事业 声音 商业 属于 适应 生意
sz	身子 始终 甚至 四周 手掌 随着 所在 实在 手指 素质
tb	特别 逃避 同比 同胞 台北 淘宝 投标 同伴 同步 图标
tc	提出 突出 天才 特长 通常 陶瓷 掏出 推出 退出 弹出
td	听到 团队 土地 它的 特点 态度 徒弟 推动 天地 提到
tf	突发 腾飞 土匪 通风 天赋 投放 痛风 台风 套房 推翻
tg	通过 提纲 透过 提供 泰国 提高 听过 推广 太过 投稿
th	谈话 挺好 桃花 他很 退回 童话 通红 通话 替换 天河
tj	条件 团结 推进 途径 听见 统计 提交 天津 台阶 推荐
tk	痛苦 瞳孔 推开 调侃 痛哭 天空 坦克 条款 图库 太空
tl	讨论 听了 透露 条例 铁路 脱离 停了 谈论 同类 叹了
tm	他们 汤姆 条码 她们 透明 甜蜜 题名 它们 题目 甜美
tn	头脑 他能 腾挪 童年 他呢 太浓 她能 它能 替你 听你
tp	谈判 调皮 突破 图片 逃跑 图谱 调配 投票 偷拍 太平
tq	提起 太强 同期 天气 天晴 同情 抬起 提前 提取 他却
tr	突然 体弱 倘若 投入 兔肉 退让 填入 土壤 坦然 同仁
ts	同时 图书 特殊 特色 它是 听说 提示 探索 天生 天色
tt	太太 铁通 体坛 团体 听听 抬头 贴图 偷偷 疼痛 谈谈
tv	图案 太阿 图二 胎儿 天啊 提案 塔尔 疼爱 天鹅 他爱
tw	台湾 条纹 天王 跳舞 突围 图文 通往 提问 听我 听完
tx	体系 投降 停下 通信 太小 同学 图形 叹息 提醒 体现
ty	统一 太阳 同样 通用 团员 体育 天涯 讨厌 体验 他又
tz	同志 太子 调整 体制 停止 投资 天真 通知 特征 逃走
vb	耳边 岸边 案板 欧版 阿贝 阿扁 二八 二百 爱不 安保
vc	暗藏 二层 爱车 暗处 按此 暗忖 耳垂 爱吃 哀愁 恩赐
vd	耳朵 二队 殴打 爱得 阿呆 安定 二代 而定 额度 额定
vf	案犯 安防 安抚 而返 阿峰 暗访 二份 爱抚 案发 安放
vg	爱国 二姑 爱过 鞍钢 昂贵 而该 儿歌 二哥 恶搞 耳光
vh	而后 爱好 爱护 安徽 暗黑 爱恨 懊悔 恶化 二号 耳环
vj	案件 二级 耳机 阿胶 暗叫 而将 而今 安静 按键 埃及
vk	安康 耳孔 阿克 儿科 爱卡 尔康 埃克 爱看 阿卡 爱哭
vl	案例 饿了 二楼 艾伦 恶劣 暗恋 二路 爱恋 阿拉 挨了
vm	澳门 鞍马 噩梦 奥秘 欧盟 欧美 偶们 恶魔 按摩 暧昧
vn	儿女 安妮 按扭 按钮 耳内 安宁 而能 安娜 懊恼 二奶
vp	安排 鞍辔 安培 矮胖 耳畔 阿婆 爱普 耳旁 欧赔 二炮
vq	爱情 鹅群 哀求 二千 暗器 案情 傲气 二期 而其 二区
vr	爱人 鹅绒 阿荣 偶然 鹅肉 爱让 恶人 愕然 黯然 而入
vs	昂首 盎司 二十 暗算 爱上 二室 暗杀 暗示 按时 而死
vt	儿童 爱她 二厅 爱他 呕吐 额头 暗叹 凹凸 而退 爱听
vv	偶尔 媕娿 偶而 阿尔 恩恩 哀哀 爱爱 恩爱 啊啊 艾尔
vw	安危 安慰 二万 爱我 澳网 爱问 耳闻 额外 二位 安稳
vx	恶心 凹陷 按下 偶像 矮小 爱心 爱惜 而行 恶性 安详
vy	而已 欧阳 奥运 安逸 哎呀 遨游 阿姨 而言 恶意 而又
vz	按照 案子 挨揍 按住 安置 欧洲 癌症 安装 艾滋 澳洲
wb	无比 尾巴 尾巴 外表 我便 晚辈 未必 为本 文本 网吧 完毕
wc	完成 挖出 维持 无处 晚餐 未曾 我猜 我才 午餐 王朝
wd	问道 误导 伟大 无敌 万吨 稳定 文档 味道 屋顶 我都
wf	无法 无缝 潍坊 万分 王非 违法 微风 王府 违反 晚饭
wg	无关 外观 无辜 五个 我刚 我该 王国 外挂 武功 违规
wh	文化 未婚 维护 为何 挽回 武汉 危害 往后 误会 温和
wj	文件 未经 危机 五金 玩具 忘记 我将 外交 玩家 网际
wk	网卡 微孔 外壳 外科 胃口 悟空 我哭 文科 我靠 文库
wl	网络 完了 未来 为例 网路 无论 物理 威力 无聊 往来
wm	我们 网民 帷幕 未免 文明 完美 我买 外贸 网名 妩媚
wn	无奈 未能 玩弄 为您 温暖 污泥 问你 为难 五年 我能
wp	无派 顽皮 我拍 文凭 物品 外婆 外频 王牌 外篇 外屏
wq	完全 委屈 为其 温泉 武器 无情 无穷 舞曲 我却 网球
wr	温柔 围绕 微软 万人 往日 污染 五人 侮辱 宛如 微弱
ws	完善 我司 武士 卫生 网上 无数 往事 为首 卧室 无声
wt	问题 舞台 委托 问他 我听 外滩 无图 网通 物体 外套
wv	我爱 维尔 无碍 威尔 我啊 文案 瓦尔 为爱 玩儿 味儿
ww	微微 娃娃 玩玩 往往 呜呜 问问 万物 文物 威望 问我
wx	微笑 危险 文献 威胁 卫星 文学 无需 无限 无形 维修
wy	唯一 我又 万一 无疑 委员 网游 万元 文艺 王爷 位于
wz	位置 屋子 完整 握住 为止 文章 武装 物质 为主 文字
xb	宣布 下巴 相比 雪白 性别 西部 下班 想必 细胞 新版
xc	形成 现出 现场 宣传 寻常 相差 写出 相处 消除 相册
xd	许多 相对 想到 显得 相当 兄弟 穴道 行动 现代 晓得
xf	幸福 消费 兴奋 相反 小幅 想法 消防 西方 媳妇 修复
xg	香港 修改 性格 相公 效果 习惯 下岗 相关 性感 选购
xh	喜欢 小孩 相互 先后 信号 下滑 型号 协会 学会 幸好
xj	小姐 下降 先进 现金 相见 选举 相机 袭击 相继 新疆
xk	胸口 细孔 辛苦 学科 显卡 星空 小康 许可 新款 新开
xl	训练 心灵 心理 旋律 线路 效率 系列 醒来 向来 下落
xm	项目 兄妹 羡慕 性命 鲜明 厦门 熊猫 姓名 消灭 小麦
xn	性能 新娘 虚拟 新年 校内 西宁 想念 西南 信念 细腻
xp	芯片 橡皮 选票 相片 新品 夏普 学派 新片 胸脯 宣判
xq	心情 先驱 兴趣 香气 镶嵌 向前 寻求 需求 先前 星期
xr	显然 虚弱 羞辱 信任 昔日 笑容 夏日 陷入 行人 形容
xs	先生 吸收 迅速 学生 小时 现实 享受 形式 形势 消失
xt	系统 向她 夏天 胸膛 相同 协调 心痛 心跳 心态 形态
xv	喜爱 狭隘 邪恶 性爱 西岸 西安 西欧 相爱 限额 希尔
xw	希望 纤维 虚无 下午 香味 行为 向往 新闻 询问 学位
xx	相信 学习 学校 信息 星星 谢谢 信心 消息 休息 现象
xy	需要 吸引 小雨 信用 校园 协议 学院 效益 相应 喜悦
xz	现在 仙子 选择 乡镇 协助 向着 学者 行政 寻找 小组
yb	一般 邮编 要不 以便 一步 一半 一本 原本 拥抱 已被
yc	因此 演出 隐藏 远处 异常 预测 演唱 由此 原创 一场
yd	一定 引导 遇到 一代 一点 印度 一动 有点 应当 一旦
yf	衣服 越发 一副 一番 一幅 依法 预防 应付 月份 一份
yg	应该 勇敢 严格 一股 眼光 有关 员工 英国 阳光 月光
yh	以后 友好 疑惑 银行 雅虎 用户 诱惑 议会 优化 遗憾
yj	已经 业绩 迎接 以及 眼睛 研究 依据 要紧 依旧 引进
yk	一块 圆孔 一款 依靠 一颗 愉快 遥控 一刻 游客 要看
yl	原来 压力 以来 娱乐 一路 眼泪 严厉 原谅 医疗 一流
ym	以免 移民 迎面 要命 幽默 阴谋 源码 页面 域名 郁闷
yn	云南 也能 越南 与你 以内 旖旎 要你 又能 因您 业内
yp	一旁 荧屏 一批 影片 药品 一派 样品 硬盘 音频 一篇
yq	一切 一群 要求 语气 仪器 以前 勇气 尤其 引起 一齐
yr	依然 犹如 炎热 引入 羊肉 要让 已然 艺人 诱人 与人
ys	于是 严肃 艺术 一身 意思 意识 右手 要是 一时 以上
yt	摇头 一台 一套 一条 原帖 丫头 液体 用途 与他 一听
yv	因而 要隘 悦耳 婴儿 阴暗 议案 鱼儿 幼儿 预案 余额
yw	因为 鱼尾 一万 业务 夜晚 以为 义务 以外 要闻 以往
yx	一些 有限 英雄 一向 有些 也许 以下 影响 有效 运行
yy	一样 医院 由于 应用 原因 愿意 远远 永远 意义 语言
yz	一直 一阵 一致 严重 原则 亚洲 沿着 样子 银子 椅子
zb	准备 嘴巴 再不 装备 逐步 转变 主板 这边 资本 指标
zc	支持 指出 造成 政策 正常 再次 嘴唇 作出 组成 做出
zd	知道 指导 找到 只得 重点 制度 自动 直到 重大 值得
zf	政府 总发 丈夫 作风 涨幅 执法 字符 做法 住房 支付
zg	这个 整改 职工 整个 祖国 最高 足够 照顾 走过 中共
zh	之后 只好 指挥 最后 招呼 珠海 中华 最好 综合 做好
zj	自己 增加 直接 资金 只见 之间 逐渐 之际 专家 中间
zk	召开 针孔 展开 专科 张口 状况 周刊 张开 最快 这款
zl	这里 走了 总理 专利 质量 资料 整理 战略 治理 长老
zm	怎么 皱眉 字幕 这么 证明 专门 知名 咱们 著名 折磨
zn	只能 职能 指南 周年 之内 支农 找你 智能 站内 子女
zp	只怕 诈骗 招聘 照片 作品 最怕 招牌 制品 自拍 这篇
zq	之前 增强 正确 赚钱 作曲 证券 抓起 追求 争取 准确
zr	众人 诸如 最热 主人 昨日 转让 之人 责任 主任 真人
zs	只是 证书 正式 转身 真是 知识 重视 这时 再说 总是
zt	总统 这台 状态 整体 主题 增添 整天 昨天 主体 专题
zv	这儿 总额 障碍 做爱 之恩 治安 作案 之二 阻碍 罪恶
zw	作为 皱纹 掌握 之外 周围 中文 暂无 诸位 中午 昨晚
zx	这些 仔细 之下 执行 最小 主席 秩序 坐下 走向 转向
zy	这样 早已 只有 作用 中央 注意 怎样 重要 只要 主要
zz	组织 桌子 真正 增长 之中 政治 阻止 抓住 作者 战争