款	kb
怒	nz
仁	rx
哦	vh
五	wz
宿	sir'
菁	jkf'
窒	zir.
庐	lgw,
诏	zwq'
曙	sif'
窖	jir.
岱	drl'
唆	soy;
珉	mfc'
伎	jrk.
姣	jnw'
剿	jll,
咫	zpw;
妤	yny,
藜	lkh'
皎	jnw.
瀛	yvw'
饺	juw;
掸	djd;
褴	lyd'
蔗	zkg;
蕲	qkd;
罹	lfx;
弈	ywm'
臃	yuw;
呶	non;
禺	yic'
绶	slz;
蚯	qcj'
蘅	hkp;
痢	lgh.
洙	zvq'
畿	jll.
摞	ljt'
郗	xxx,
雠	crf'
炀	yhj'
濠	hvw.
搠	sjk.
啁	zoc'
蹉	cnd.
鬻	ygd'
韶	slio
邑	yoao
惺	xxiu
嬴	ywoe
赂	lhua
茧	jkio
汀	tvea
璨	cfee
翦	jkue
渲	xvia
嫦	cneu
唁	yooo
黍	shaa
牍	drea
撺	cjiu
牖	yrea