b	不 办 本 便 吧 被 必 并 表 报 变 步 比 边 把 白 别 部
c	出 参 才 处 常 产 吃 长 场 重 传 程 车 除 成 从 此 次
d	的 队 到 多 点 定 打 地 都 动 第 等 但 对 大 得 当 道
f	发 费 否 风 峰 法 府 放 反 服 复 父 房 飞 夫 分 非 方
g	个 改 工 各 光 关 管 果 更 感 干 该 功 给 过 公 国 高
h	和 红 花 后 黑 活 华 很 何 合 火 海 化 好 还 会 回 话
j	就 己 机 今 叫 将 建 间 加 金 解 接 觉 经 进 几 见 家
k	可 恳 克 科 肯 空 块 刻 客 苦 狂 考 况 孔 开 看 口 快
l	了 灵 两 脸 路 冷 量 老 理 连 落 龙 林 力 来 利 里 立
m	没 马 模 们 吗 美 忙 么 命 目 母 每 满 民 面 名 明 门
n	你 能 弄 拿 呢 宁 念 女 难 娘 怒 哪 男 那 南 年 内 农
p	平 陪 排 朋 跑 派 婆 旁 批 配 盘 拍 普 皮 破 片 品 怕
q	去 群 其 气 器 情 区 却 轻 清 求 青 亲 强 起 全 且 前
r	人 忍 热 入 肉 认 荣 任 容 仍 弱 软 柔 如 若 然 日 让
s	是 书 声 生 时 实 神 身 所 少 使 十 三 双 事 手 上 说
t	他 通 太 特 听 它 谈 提 题 条 台 突 统 她 天 体 同 头
v	而 娥 耳 爱 啊 案 奥 尔 按 恩 额 恶 欧 阿 二 儿 暗 安
w	我 屋 王 位 网 问 往 文 望 万 完 未 五 维 无 外 晚 为
x	下 细 现 行 些 学 西 向 相 新 性 信 先 线 想 笑 小 心
y	一 以 要 月 业 应 因 已 又 于 由 与 样 也 有 用 眼 意
z	在 展 走 知 只 这 种 之 作 主 住 再 真 子 正 自 中 着
ba	边
be	把
bi	别
bo	部
bu	白
ca	除
ce	成
ci	此
co	次
cu	从
da	对
de	大
di	当
do	道
du	得
fa	飞
fe	夫
fi	非
fo	方
fu	分
ga	给
ge	过
gi	国
go	高
gu	公
ha	好
he	还
hi	回
ho	话
hu	会
ja	经
je	进
ji	见
jo	家
ju	几
ka	孔
ke	开
ki	口
ko	快
ku	看
la	力
le	来
li	里
lo	立
lu	利
ma	民
me	面
mi	明
mo	门
mu	名
na	那
ne	南
ni	内
no	农
nu	年
pa	皮
pe	破
pi	品
po	怕
pu	片
qa	强
qe	起
qi	且
qo	前
qu	全
ra	如
re	若
ri	日
ro	让
ru	然
sa	双
se	事
si	上
so	说
su	手
ta	她
te	天
ti	同
to	头
tu	体
va	阿
ve	二
vi	暗
vo	安
vu	儿
wa	维
we	无
wi	晚
wo	为
wu	外
xa	线
xe	想
xi	小
xo	心
xu	笑
ya	也
ye	有
yi	眼
yo	意
yu	用
za	子
ze	正
zi	中
zo	着
zu	自
bb	并不 半边 本报 不便 宝贝 不必 报表 宝宝 爸爸 不变 版本
bc	不错 奔驰 变成 报仇 彼此 不曾 编程 保持 补充 保存 本次
bd	不得 部队 表达 不但 宝典 不断 不等 报道 必定 半岛 拔掉
bf	办法 不妨 冰封 步伐 并非 北方 报复 播放 备份 爆发 颁发
bg	不过 不敢 罢工 不管 曝光 不该 宾馆 报告 不够 不顾 办公
bh	保护 办好 变换 变化 编号 北海 便会 背后 包含 百货 不含
bj	不仅 巴结 不禁 不久 背景 北京 不解 比较 毕竟 不及 不觉
bk	不肯 鼻孔 包括 本科 被困 博客 报考 避开 不堪 板块 便可
bl	本来 罢了 不理 巴黎 变量 不论 办理 不料 本领 玻璃 冰冷
bm	部门 不妙 表面 罢免 表明 不满 报名 避免 不免 帮忙 保密
bn	半年 不能 别扭 百年 保暖 不宁 比拟 不难 本能 并能 便能
bp	不怕 被骗 编排 被迫 本品 背叛 变频 本片 奔跑 帮派 本篇
bq	并且 百强 版权 标签 兵器 表情 本期 比起 不清 抱歉 病情
br	别人 不忍 变软 必然 本日 不容 薄弱 本人 病人 比如 步入
bs	表示 本书 办事 本身 不少 比赛 部署 不时 半晌 博士 白色
bt	不同 不通 半天 摆脱 标题 包头 本土 不太 不停 变态 补贴
bv	不安 保安 北欧 不爱 彼岸 备案 本案 悲哀 比尔 贝尔 办案
bw	把握 保卫 百万 部位 包围 不问 傍晚 本文 并未 并无 变为
bx	必须 保险 表现 不行 变小 不许 百姓 不幸 八仙 不限 不详
by	不要 不已 必要 本月 不易 表演 不由 毕业 本页 不愿 扮演
bz	不住 保障 不再 部长 帮助 保证 不止 标准 不足 不准 脖子
cb	出版 承办 成本 苍白 初步 传遍 储备 传播 差别 翅膀 崇拜
cc	常常 传出 尺寸 匆匆 虫虫 层次 存储 重重 财产 长长 抽出
cd	程度 车队 颤抖 吃得 差点 彻底 长度 承担 冲动 成都 菜单
cf	充分 长发 查封 吃饭 处罚 厨房 厂房 采访 重复 财富 惩罚
cg	成功 参观 超过 持股 成果 超高 常规 采购 错过 唱歌 穿过
ch	窗户 才好 策划 才会 称呼 仇恨 彩虹 称号 场合 此后 词汇
cj	参加 曾经 促进 长久 常见 吃惊 此间 长剑 成绩 刺激 长江
ck	此刻 诚恳 参考 查看 窗口 仓库 刺客 存款 残酷 乘客 察看
cl	出来 吃了 处理 彩铃 策略 材料 错了 产量 传来 车辆 测量
cm	充满 村民 场面 驰名 聪明 车门 出卖 沉默 传媒 层面 侧面
cn	才能 超女 嘲弄 菜鸟 车内 承诺 城内 常年 处女 产能 采纳
cp	产品 彩屏 彩票 唱片 超频 裁判 草坪 磁盘 测评 诚聘 钞票
cq	采取 超强 长期 春秋 插曲 重庆 拆迁 产权 传奇 初期 城区
cr	承认 脆弱 耻辱 仇人 春日 从容 出任 插入 残忍 超人 出入
cs	此时 纯属 传输 产生 才是 城市 参数 措施 测试 沉思 成熟
ct	传统 出台 餐厅 朝廷 长叹 冲突 撤退 春天 长途 成套 畅通
cv	从而 嫦娥 尘埃 宠爱 承恩 长安 差额 草案 此案 初二 刺耳
cw	成为 创维 从未 窗外 春晚 错误 传闻 称为 财务 宠物 常务
cx	出现 持续 呈现 朝鲜 晨曦 程序 成效 重新 出席 创新 查询
cy	产业 诧异 参与 采用 成员 创意 草原 沉吟 处于 迟疑 出于
cz	存在 车子 财政 操作 初中 穿着 城镇 创造 沉重 创作 成长
db	代表 躲避 打扮 担保 地步 大半 对比 大步 多半 东北 都不
dc	调查 单纯 达成 到处 点此 当初 地产 多次 当场 低沉 电池
dd	得到 导弹 达到 等待 地点 到底 懂得 地道 淡淡 当地 等到
df	地方 打发 颠覆 对付 大幅 东方 多方 到访 东风 答复 豆腐
dg	大哥 大纲 大概 多个 德国 蛋糕 点歌 灯光 帝国 东莞 订购
dh	的话 多好 动画 都会 带回 电话 都很 大汉 等候 导航 得很
dj	大家 大局 打击 多久 大叫 东京 点击 当今 代价 动静 登记
dk	打开 打孔 贷款 都看 端口 带宽 洞口 对抗 抵抗 雕刻 大哭
dl	带来 大陆 道理 带领 大量 独立 到了 道路 打量 到来 登录
dm	多么 大马 地面 多名 东盟 动漫 店面 代码 都没 倒霉 大米
dn	多年 都能 东南 电脑 党内 大闹 电能 大脑 大怒 店内 大娘
dp	大批 肚皮 打破 大盘 毒品 点评 跌破 搭配 店铺 短片 地盘
dq	地区 党群 的确 电气 电器 道歉 短期 地球 定期 对其 读取
dr	当然 刀刃 打扰 敌人 冬日 点燃 导入 担任 动人 陡然 等人
ds	但是 读书 低声 打算 多少 电视 动手 当时 地上 大师 倒是
dt	点头 电台 动态 独特 打听 低头 地铁 地图 冬天 代替 大厅
dv	第二 窦娥 东欧 点儿 对啊 答案 顶啊 档案 戴尔 定额 对岸
dw	单位 大卫 第五 地位 电网 耽误 到位 队伍 党委 动物 定位
dx	东西 短线 地下 对象 弟兄 担心 大喜 大学 大型 底下 低下
dy	第一 大约 对于 地狱 电影 答应 得以 定义 党员 等于 对应
dz	弟子 肚子 当真 动作 得罪 带着 多种 斗争 读者 电子 当作
fb	分别 反驳 发表 方便 腐败 封闭 发病 分布 发布 风暴 法宝
fc	非常 付出 方才 风采 发财 房产 服从 扶持 放出 飞船 复仇
fd	反对 辅导 负担 非但 非典 奋斗 发达 发动 饭店 发抖 反倒
ff	方法 纷纷 防范 仿佛 吩咐 丰富 复发 夫妇 非法 反复 发放
fg	法国 分隔 放过 分管 风光 覆盖 发光 法规 风格 分割 法官
fh	发挥 粉红 防护 符合 返回 复活 废话 复合 凤凰 符号 发货
fj	房间 福建 飞机 附近 风景 发觉 佛教 分解 附件 房价 附加
fk	放开 复垦 反抗 疯狂 封口 访客 妇科 付款 反馈 罚款 反恐
fl	法律 翻了 飞龙 福利 房里 分类 泛滥 分离 风流 分裂 犯了
fm	方面 父母 封面 风貌 仿冒 房门 分泌 丰满 抚摸 负面 阀门
fn	妇女 愤怒 抚弄 飞鸟 房内 烦恼 发难 方能 发怒 父女 粉嫩
fp	分配 放屁 发票 扶贫 废品 反叛 富婆 肥胖 复牌 分批 发泡
fq	父亲 奉劝 夫妻 风气 分歧 放弃 扶起 风情 分区 番茄 泛起
fr	夫人 缝纫 繁荣 妇人 肥肉 否认 富人 芙蓉 法人 放入 发热
fs	发生 附属 方式 翻身 凡是 发送 服饰 放松 发誓 放手 风声
ft	反弹 佛陀 封套 繁体 附图 法庭 翻腾 丰田 访谈 沸腾 风头
fv	反而 份额 妨碍 风儿 飞蛾 方案 防癌 法案 肺癌 份儿 父爱
fw	服务 房屋 发威 飞舞 范围 访问 绯闻 氛围 风味 富翁 防伪
fx	发现 风险 分析 方向 反响 放心 分享 放下 发行 奉献 飞行
fy	反应 法院 飞扬 费用 反映 发言 房源 富有 翻译 风云 防御
fz	发展 房子 负责 分钟 否则 非洲 法子 反正 复杂 犯罪 方针
gb	根本 改编 公布 官兵 告别 干部 更不 改变 广播 关闭 贵宾
gc	工程 高层 刚才 过程 歌唱 观察 工厂 贯彻 构成 干脆 广场
gd	感到 宫殿 广大 孤独 观点 规定 广东 各地 高度 赶到 感动
gf	功夫 国防 规范 股份 高峰 广泛 辜负 工夫 官方 购房 各方
gg	改革 更改 哥哥 各个 刚刚 古怪 尴尬 各国 格格 广告 乖乖
gh	规划 搞好 更换 过后 光辉 关怀 光滑 刚好 更好 工会 供货
gj	国家 国际 根据 关键 工具 感觉 公斤 更加 各级 感激 攻击
gk	公开 管孔 高考 观看 港口 赶快 感慨 顾客 广阔 更快 过客
gl	管理 功力 鼓励 规律 公路 各类 桂林 光临 攻略 功率 过滤
gm	革命 购买 规模 改名 光明 歌迷 哥们 光芒 感冒 干嘛 干吗
gn	姑娘 功能 赣南 观念 供暖 工农 更难 概念 更能 归纳 狗年
gp	公平 滚屏 股票 光盘 高频 各派 狗屁 挂牌 该片 古朴 攻破
gq	过去 光驱 供求 国企 歌曲 感情 过期 跟前 敢情 股权 钢琴
gr	果然 刚柔 光荣 工人 骨肉 感染 公认 怪人 固然 各人 干扰
gs	告诉 公司 故事 感受 更是 改善 攻势 高速 工商 高声 拱手
gt	共同 沟通 国土 钢铁 感叹 骨头 宫廷 港台 柜台 固体 关头
gv	公安 关隘 故而 关爱 感恩 港澳 高傲 孤儿 个案 高昂 高额
gw	各位 恭维 国王 怪物 官网 更为 高温 岗位 购物 顾问 改为
gx	关系 光线 阁下 购销 功勋 高兴 甘心 关心 贡献 感谢 个性
gy	关于 怪异 共有 共用 工业 故意 国语 官员 过于 供应 工艺
gz	工作 故障 果真 各种 规则 跟着 关注 公主 各自 改造 观众
hb	毫不 回避 回报 伙伴 河北 何必 合并 货币 环保 湖北 火爆
hc	何处 画出 火车 好处 好吃 缓冲 换成 合成 很长 缓存 号称
hd	活动 混蛋 回到 回答 蝴蝶 皇帝 好多 很多 获得 忽地 何等
hf	恢复 花费 会否 回复 横幅 合法 哈佛 合肥 划分 护肤 后方
hg	回归 宏观 回顾 火锅 韩国 很高 海关 后果 火光 化工 合格
hh	缓缓 很好 绘画 狠狠 哈哈 后悔 呼唤 嘿嘿 呵呵 黄河 黄昏
hj	环境 韩剧 环节 黄金 罕见 喝酒 火箭 伙计 好久 痕迹 很久
hk	很快 汗孔 汇款 回馈 户口 何况 贺卡 航空 黑客 海口 花开
hl	回来 活力 后来 混乱 喉咙 婚礼 花了 合理 欢乐 含量 怀里
hm	后面 黑马 号码 毫秒 好吗 昏迷 皇马 画面 缓慢 毫米 毁灭
hn	河南 很难 湖南 怀念 回暖 胡闹 候鸟 还能 海南 华南 好难
hp	害怕 黑屏 琥珀 魂魄 货品 好评 划破 活泼 惠普 湖泊 花瓶
hq	回去 很强 好奇 花钱 火器 行情 红旗 获取 环球 后期 后勤
hr	忽然 环绕 火热 华人 韩日 红润 湖人 坏人 黑人 赫然 后人
hs	还是 回收 华硕 浑身 和尚 函数 红色 皇上 或是 黑色 何时
ht	回头 后退 航天 话筒 话题 会谈 海滩 合同 糊涂 后台 好听
hv	黑暗 姮娥 和蔼 海尔 好啊 毫安 孩儿 花儿 海岸 昏暗 很爱
hw	毫无 后卫 好玩 海外 回味 化为 华为 户外 货物 还未 红外
hx	或许 和弦 互相 好像 呼吸 核心 化学 含笑 欢喜 好些 好象
hy	还有 何以 还要 怀疑 行业 会议 黑影 欢迎 花园 回忆 婚姻
hz	孩子 汉子 或者 合作 怀中 汉字 活着 胡子 会长 杭州 患者
jb	基本 举办 绝不 肩膀 脚步 疾病 具备 决不 进步 级别 金币
jc	基础 基层 坚持 进程 经常 警察 继承 检查 接触 决策 建成
jd	觉得 绝对 见到 记得 监督 决定 军队 简单 巨大 激动 阶段
jf	解放 经费 姐夫 肌肤 绝非 警方 机房 积分 减肥 纠纷 激发
jg	结果 交给 结构 尽管 金刚 机关 军官 机构 价格 警告 加工
jh	几乎 结婚 计划 机会 惊呼 江湖 交换 结合 家伙 讲话 今后
jj	经济 拒绝 积极 接近 紧紧 解决 坚决 究竟 渐渐 姐姐 将军
jk	加快 祭孔 解开 紧靠 接口 健康 监控 尽快 剑客 艰苦 即可
jl	建立 极了 将来 纪律 尽量 距离 角落 交流 经历 激烈 记录
jm	见面 居民 局面 经贸 节目 急忙 精美 寂寞 紧密 界面 加盟
jn	今年 艰难 江南 近年 境内 拘泥 佳能 纪念 技能 济南 节能
jp	金牌 精辟 机票 键盘 精品 浸泡 惧怕 极品 奖品 解剖 敬佩
jq	加强 坚强 及其 健全 机器 交情 金钱 举起 极其 惊奇 减轻
jr	进入 假如 金融 既然 今日 兼容 惊人 居然 竟然 加入 近日
js	建设 介绍 技术 接受 加上 精神 计算 就算 即使 解释 结束
jt	今天 交通 静态 具体 集团 家庭 简体 集体 肩头 交谈 教堂
jv	骄傲 金娥 继而 饥饿 激昂 金额 劲儿 教案 巨额 煎熬 惊愕
jw	极为 结尾 紧握 交往 今晚 绝望 境外 均为 较为 仅为 几位
jx	进行 继续 脚下 举行 揭晓 决心 惊喜 教训 教学 景象 机械
jy	教育 经验 具有 监狱 就业 建议 给予 就要 经营 基于 惊讶
jz	记者 紧张 简直 机制 集中 接着 进展 竞争 价值 建筑 教主
kb	恐怖 捆绑 开本 空白 拷贝 看病 快步 开办 快报 课本 狂奔
kc	看出 扣除 快车 课程 快餐 考察 堪称 库存 开车 开创 客场
kd	看到 刊登 扩大 口袋 快点 肯定 开店 宽带 快递 可达 宽度
kf	开发 刊发 可否 克服 咖啡 开放 开封 看法 客服 康复 客房
kg	客观 可观 快感 控股 跨国 开关 矿工 可供 开工 考古 空格
kh	客户 科幻 考核 抗衡 口号 快活 恐慌 抗洪 困惑 开户 开花
kj	看见 框架 科技 靠近 盔甲 空间 课件 恐惧 抗拒 会计 快捷
kk	看看 开垦 苦苦 可靠 空旷 慷慨 刻苦 开阔 空空 宽阔 坎坷
kl	看来 刻录 恐龙 快乐 考虑 可怜 骷髅 颗粒 可乐 开朗 克隆
km	开门 快马 开幕 科贸 昆明 苦闷 开卖 科目 楷模 苦命 快慢
kn	可能 困难 柯南 渴念 课内 苦恼 狂怒 苦难 矿难 空难 哭闹
kp	恐怕 开辟 开拍 卡片 宽频 科普 看盘 开盘 宽屏 考评 快跑
kq	口气 跨骑 开枪 客气 况且 开启 口腔 空气 哭泣 块钱 看清
kr	客人 可忍 困扰 狂人 抗日 宽容 跨入 狂热 扩容 烤肉 考入
ks	开始 看书 快速 考生 口水 考试 可使 开设 亏损 款式 看似
kt	客厅 开通 开拓 卡特 课堂 空调 抗体 卡通 课题 可调 开庭
kv	可爱 看啊 可按 科尔 口岸 抗癌 靠岸 酷爱 克尔 凯恩 库尔
kw	渴望 库娃 可恶 刊物 口味 看完 可望 可谓 课文 看望 课外
kx	科学 空隙 康熙 苦笑 空虚 可惜 可向 可选 快讯 开学 可行
ky	可以 考验 科研 可疑 开业 抗议 跨越 快要 考研 刻意 口语
kz	控制 开展 客栈 可知 空中 靠着 看著 扩展 扩张 夸张 裤子
lb	老板 两边 联邦 老爸 类别 脸部 离别 列表 路边 来吧 喇叭
lc	露出 楼层 立场 流程 理财 两次 流传 临床 列车 凌晨 历程
ld	领导 脸蛋 来到 懒得 来电 力度 老道 劳动 懒惰 落地 料到
lf	浪费 裂缝 老夫 礼服 两幅 立法 两份 来访 疗法 楼房 雷锋
lg	两国 乐观 掠过 旅馆 牢固 楼阁 留给 两个 老公 路过 理工
lh	厉害 良好 灵魂 联合 老虎 冷汗 绿化 理会 落后 灵活 离婚
lj	立即 邻居 冷静 了解 冷峻 累计 路径 理解 连接 逻辑 脸颊
lk	离开 脸孔 拉开 理科 路口 立刻 轮廓 凌空 旅客 两款 冷酷
ll	理论 联络 连连 凌乱 力量 利率 流量 来历 凌厉 流露 浏览
lm	里面 罗马 路面 礼貌 联盟 连忙 两名 冷漠 浪漫 栏目 厘米
ln	理念 鲁能 岭南 两年 冷暖 辽宁 留念 六年 老年 历年 靓女
lp	老婆 脸皮 连拍 楼盘 礼品 脸庞 两片 两旁 流派 老牌 路旁
lq	离去 列强 乐趣 力气 利器 恋情 冷却 篮球 录取 领取 力求
lr	老人 例如 冷热 两人 落日 利润 猎人 令人 录入 恋人 列入
ls	历史 螺丝 厉声 脸色 路上 落实 老实 立时 粮食 老师 泪水
lt	老头 联通 楼梯 两条 聆听 龙头 两天 老天 论坛 聊天 流通
lv	两岸 老媪 老二 恋爱 来啊 立案 莱恩 灵儿 里昂 怜爱 雷傲
lw	另外 螺纹 两万 礼物 联网 论文 劳务 来往 两位 例外 列为
lx	冷笑 连续 留下 联系 流星 良心 履行 类型 理想 路线 老朽
ly	利用 洛阳 领域 老爷 理由 利益 乐园 旅游 留意 留言 来源
lz	来自 老子 老者 理智 两只 楼主 例子 拦住 两种 连载 留在
mb	明白 民办 目标 面包 漫步 毛病 麻痹 模板 面板 弥补 美白
mc	名称 冒出 马车 没错 没吃 每次 门窗 漫长 名词 摩擦 木材
md	目的 摩登 猛地 矛盾 目睹 名单 密度 免得 蓦地 买到 每当
mf	麻烦 免费 密封 埋伏 莫非 魔法 美发 模仿 没法 买房 模范
mg	美国 美观 玫瑰 某个 目光 迷宫 民工 蒙古 每个 敏感 魔鬼
mh	模糊 美好 漫画 幕后 猛虎 门户 民航 梦幻 棉花 迷惑 美化
mj	面积 灭绝 民警 秘籍 模具 民间 秘诀 美军 买家 卖家 名叫
mk	门口 毛孔 模块 每科 满口 没空 迈克 煤矿 门槛 麦克 马克
ml	美丽 魅力 忙碌 命令 面临 明亮 魔力 目录 买了 名录 米兰
mm	慢慢 妈妈 买卖 面貌 默默 秘密 命名 妹妹 密码 木马 盲目
mn	美女 没能 模拟 每年 猛男 木讷 磨难 泌尿 闽南 魔女 母女
mp	门派 毛皮 门票 名牌 苗圃 面庞 马屁 马匹 猫扑 买票 买盘
mq	目前 勉强 明确 没钱 麻雀 母亲 谋求 密切 煤气 默契 名气
mr	美人 毛绒 闷热 猛然 每日 面容 默认 茫然 迷人 蓦然 美容
ms	马上 秘书 模式 面色 牧师 魔兽 面试 描述 陌生 美食 美术
mt	明天 每台 每天 媒体 煤炭 眉头 命题 模特 码头 摩托 馒头
mv	名额 母爱 木耳 摩尔 蒙恩 命案 莫尔 木偶 马儿 猫儿 马鞍
mw	门外 满屋 魔王 每位 美味 美文 没完 灭亡 每晚 迷惘 迷雾
mx	模型 冒险 梦想 面向 明显 描写 迷信 某些 明星 慢性 买下
my	没有 绵阳 美元 每月 贸易 满意 每一 模样 命运 面议 每页
mz	名字 帽子 免责 明知 满足 民族 每周 民主 妹子 盟主 某种
nb	那边 泥巴 能把 那般 南北 宁波 难保 能不 年报 那本 那帮
nc	农村 拿出 内存 昵称 南昌 年初 奶茶 年产 农场 内测 那场
nd	难道 能对 内地 年代 难点 年度 年底 脑袋 难得 拿到 难度
nf	能否 内附 那副 年份 那幅 奶粉 念佛 那份 女方 男方 难分
ng	那个 能给 难过 能够 凝固 难怪 能干 内功 哪个 南宫 那股
nh	女孩 男孩 浓厚 年华 呐喊 怒火 内核 脑海 内涵 南海 农户
nj	年纪 年级 宁静 脑筋 年鉴 南京 那件 年间 凝聚 能将 内建
nk	难看 农垦 宁可 能看 那颗 内裤 尼克 尼康 那块 内科 难堪
nl	那里 努力 拿来 男篮 哪里 女郎 拿了 能力 年龄 能量 南路
nm	你们 难民 内幕 那么 纽曼 纳米 南美 难免 匿名 纳闷 柠檬
nn	男女 奶奶 能耐 奶牛 喃喃 南宁 娘娘 牛奶 浓浓 暖暖 恼怒
np	哪怕 牛皮 女排 涅盘 尿频 奶瓶 女仆 牛排 内屏 男排 那篇
nq	年轻 那群 拿起 怒气 扭曲 弄清 内情 拿去 暖气 年青 拿钱
nr	女人 懦弱 耐热 男人 牛肉 内容 嗫嚅 能让 纳入 难忍 能人
ns	那时 浓缩 女士 难受 乃是 凝视 女神 女生 男生 男士 女声
nt	念头 南通 泥土 那条 难题 扭头 女童 哪天 农田 难逃 难听
nv	女儿 鸟儿 难熬 哪儿 南岸 脑癌 奈尔 男儿 溺爱 内尔 妞儿
nw	那位 女娲 女王 哪位 内网 难忘 难为 能为 挪威 凝望 女巫
nx	那些 年限 宁夏 内向 哪些 女性 年薪 男性 耐心 女星 拿下
ny	那样 难以 女友 能用 农业 能源 宁愿 纽约 内衣 能有 哪有
nz	女子 男子 能在 那种 内置 拿着 那张 娘子 脑子 那只 乃至
pb	旁边 碰壁 屏蔽 配备 跑步 普遍 评比 疲惫 平板 陪伴 瀑布
pc	平常 派出 跑车 赔偿 品尝 评测 排出 排除 破产 片长 跑出
pd	判断 排队 碰到 平等 盘点 频道 浦东 跑到 庞大 平淡 评定
pf	佩服 批发 牌坊 皮肤 篇幅 配方 排放 平凡 评分 频繁 票房
pg	屁股 旁观 皮革 评估 苹果 偏高 抛光 跑过 飘过 排骨 品格
ph	破坏 偏好 破获 配合 批号 平滑 跑回 平衡 排行 徘徊 彷徨
pj	平静 评级 平均 评价 瞥见 啤酒 判决 配件 破解 凭借 普及
pk	片刻 炮孔 抛开 偏科 贫困 凭空 撇开 扑克 破空 跑开 铺开
pl	漂亮 跑了 披露 毗邻 批量 评论 破裂 频率 排列 疲劳 拍了
pm	拼命 匹马 屏幕 排名 喷墨 平米 破灭 拍卖 泡沫 媲美 飘渺
pn	陪你 泡妞 皮囊 便佞 睥睨 叛逆 瓶内 婆娘 排尿 贫农 棚内
pp	偏偏 屁屁 拍拍 品牌 频频 批评 偏僻 婆婆 匹配 飘飘 批判
pq	脾气 骠骑 跑去 喷泉 派遣 抛弃 片区 聘请 迫切 贫穷 排球
pr	平日 譬如 疲软 仆人 皮肉 漂染 飘然 派人 骗人 旁人 烹饪
ps	平时 评书 拍摄 迫使 爬上 配送 攀升 评审 菩萨 破碎 碰上
pt	普通 平台 配套 胚胎 陪同 烹调 陪她 葡萄 平坦 拼图 菩提
pv	平安 偏爱 皮埃 配偶 佩恩 配额 拍案 破案 普尔 皮尔 帕尔
pw	颇为 片尾 喷雾 平稳 品味 盼望 排污 品位 评委 评为 票务
px	培训 拍戏 剖析 评选 咆哮 排序 拍下 平行 皮鞋 平息 盘旋
py	朋友 濮阳 颇有 飘逸 番禺 培养 评议 便宜 培育 拼音 平原
pz	批准 牌子 碰撞 品种 配置 凭证 膨胀 品质 拍照 骗子 胖子
qb	全部 墙壁 情报 确保 前辈 欠扁 骑兵 区别 去吧 请把 却不
qc	清楚 取出 汽车 全程 清晨 其次 球场 青春 清除 器材 全场
qd	取得 球队 全都 期待 起点 确定 青岛 强调 启动 渠道 驱动
qf	气氛 群发 勤奋 缺乏 岂非 气愤 前锋 欺负 侵犯 清风 起伏
qg	全国 奇观 情感 劝告 求购 奇怪 切割 情歌 器官 乞丐 牵挂
qh	前后 恰好 切换 强化 漆黑 侵害 奇幻 清华 期货 气候 青海
qj	期间 全局 请教 全集 情景 奇迹 强劲 瞧见 前景 情节 清洁
qk	情况 勤恳 期刊 请看 缺口 请客 亲口 乾坤 千克 轻快 晴空
ql	起来 权力 强烈 权利 千里 确立 桥梁 清理 潜力 情侣 青睐
qm	前面 巧妙 起码 签名 曲目 球迷 骑马 亲密 去买 奇妙 期末
qn	去年 全能 气囊 青年 区内 气恼 却能 千年 潜能 期内 岂能
qp	强迫 欺骗 汽配 亲朋 期盼 气派 切片 全屏 全盘 钦佩 俏皮
qq	轻轻 牵强 请求 齐全 瞧瞧 悄悄 情趣 亲切 全球 前期 侵权
qr	情人 轻柔 亲热 亲人 秋日 确认 潜入 悄然 穷人 侵入 奇瑞
qs	其实 全书 轻松 全身 签署 确实 气势 起身 轻声 切实 趋势
qt	其他 前台 前提 前途 企图 其它 洽谈 拳头 群体 气体 秋天
qv	请按 邱隘 其二 企鹅 去啊 全额 妻儿 去爱 情爱 求爱 前额
qw	千万 前卫 权威 前往 趣味 请问 气味 全文 期望 请勿 气温
qx	情形 情绪 清醒 气息 清晰 取消 缺陷 权限 全新 期限 请先
qy	企业 奇异 区域 其余 轻易 青衣 请与 权益 亲眼 球员 却又
qz	其中 妻子 求职 群众 求助 庆祝 去做 亲自 请在 去找 气质
rb	日本 入编 日报 日版 让步 如冰 人保 热播 人本 仍不 肉搏
rc	如此 认出 人才 日程 日常 热潮 蠕虫 日产 人称 热忱 认错
rd	人大 荣登 热带 认得 热点 认定 人到 人多 瑞典 弱点 入党
rf	若非 染发 瑞丰 如风 乳峰 乳房 热敷 热风 人防 燃放 润肤
rg	如果 扔给 若干 入股 认购 乳沟 软管 人工 人格 绕过 日光
rh	如何 染红 日韩 然后 如虹 润滑 柔和 任何 日后 融合 荣获
rj	人家 人际 人均 如今 仍旧 人间 仍将 软件 日记 日军 日渐
rk	人口 入孔 认可 仁科 入口 入库 日刊 仍可 任课 日寇 绕开
rl	人类 热力 热烈 扰乱 容量 燃料 日落 日历 热量 人流 锐利
rm	人民 人马 热卖 人们 辱骂 热门 人命 入门 任命 容貌 如梦
rn	热闹 人能 忍耐 人脑 入内 惹恼 热能 容纳 若能 仍能 如能
rp	人品 肉皮 肉票 任凭 乳品 热评 肉排 肉片 肉品 软皮 软片
rq	热情 人群 人权 人气 容器 柔情 人情 日期 入侵 燃气 日趋
rr	仍然 容忍 柔软 融入 嚷嚷 认认 惹人 软弱 柔弱 柔柔 软软
rs	认识 人参 人士 人生 仍是 人数 热水 忍受 燃烧 瑞士 人身
rt	如同 融通 热土 软体 认同 让它 如题 如图 肉体 乳头 忍痛
rv	然而 仁爱 入耳 热爱 人啊 乳癌 软腭 蓉儿 仍按 日俄 乳儿
rw	认为 柔婉 仍未 任务 入围 人文 入网 人物 日文 融为 热舞
rx	人心 热线 如需 热血 瑞星 入学 热销 热心 人性 人选 入选
ry	人员 人又 仍有 日月 容易 日益 人要 任意 荣誉 日语 人影
rz	日子 入驻 认真 入住 日照 认证 任职 日志 融资 忍者 认知
sb	身边 手臂 上班 设备 失败 生病 顺便 随便 士兵 双臂 识别
sc	市场 伸出 时辰 深处 时常 生产 适才 身材 首次 生成 输出
sd	说道 神殿 受到 似的 闪电 速度 首都 时代 手段 使得 上帝
sf	十分 沙发 是否 师父 山峰 算法 书房 身份 舒服 手法 身分
sg	送给 输给 事故 三个 收购 身高 帅哥 时光 施工 四个 水果
sh	时候 嗜好 深厚 社会 收回 生活 伤害 似乎 身后 上海 丝毫
sj	时间 世纪 数据 事件 世界 设计 睡觉 实际 书记 实践 随即
sk	时刻 锁孔 思考 收看 伤口 深刻 水库 书库 上课 时空 书刊
sl	上来 实力 树林 顺利 商量 设立 率领 胜利 势力 森林 数量
sm	什么 市民 四面 生命 双目 沙漠 数码 神秘 声明 水面 师妹
sn	少女 谁能 深南 少年 室内 水泥 四年 首脑 三年 十年 思念
sp	水平 受骗 审批 商铺 商品 身旁 审判 食品 视频 饰品 食谱
sq	事情 四强 失去 生气 神器 神情 山区 时期 身躯 死去 申请
sr	虽然 瘦弱 骚扰 收入 生日 湿润 诗人 深入 杀人 死人 输入
ss	身上 税收 收拾 伸手 算是 实施 杀死 事实 神色 受伤 随时
st	身体 使她 生态 尸体 试题 石头 试图 神态 舌头 三天 视听
sv	是啊 素娥 十二 索爱 上岸 数额 涉案 少儿 时而 所爱 深爱
sw	所谓 侍卫 尚未 上午 上网 死亡 事物 失望 事务 手腕 食物
sx	实现 视线 思想 首先 师兄 伤心 属性 身形 实行 剩下 熟悉
sy	所以 实验 所有 使用 事业 声音 商业 属于 适应 生意 少爷
sz	身子 始终 甚至 四周 手掌 随着 所在 实在 手指 素质 谁知
tb	特别 逃避 同比 同胞 台北 淘宝 投标 同伴 同步 图标 通报
tc	提出 突出 天才 特长 通常 陶瓷 掏出 推出 退出 弹出 题材
td	听到 团队 土地 它的 特点 态度 徒弟 推动 天地 提到 头顶
tf	头发 突发 土匪 通风 天赋 投放 痛风 台风 套房 推翻 颓废
tg	通过 提纲 透过 提供 泰国 提高 听过 推广 太过 投稿 团购
th	谈话 挺好 桃花 同行 退回 童话 通红 通话 替换 天河 它会
tj	条件 团结 推进 途径 听见 统计 提交 天津 台阶 推荐 添加
tk	痛苦 瞳孔 推开 调侃 痛哭 天空 坦克 条款 图库 太空 调控
tl	讨论 听了 透露 条例 铁路 脱离 停了 谈论 同类 叹了 涂料
tm	他们 汤姆 条码 她们 透明 甜蜜 题名 它们 题目 甜美 提名
tn	头脑 它能 腾挪 童年 她呢 太浓 它那 体能 她能 太难 托尼
tp	谈判 调皮 突破 图片 逃跑 图谱 调配 投票 偷拍 太平 托盘
tq	提起 太强 同期 天气 天晴 同情 特区 提前 提取 听取 抬起
tr	突然 体弱 倘若 投入 兔肉 退让 填入 土壤 坦然 同仁 踏入
ts	同时 图书 特殊 特色 踏上 听说 提示 探索 天生 天色 天使
tt	太太 铁通 体坛 团体 听听 抬头 贴图 偷偷 疼痛 谈谈 天堂
tv	图案 疼爱 退而 胎儿 天啊 提案 途安 天鹅 徒儿 太爱 投案
tw	台湾 条纹 天王 跳舞 突围 图文 天文 提问 听完 通往 体温
tx	天下 投降 停下 体系 太小 同学 图像 通信 叹息 提醒 体现
ty	统一 太阳 同样 通用 团员 体育 提议 讨厌 体验 天涯 太原
tz	同志 太子 调整 体制 停止 投资 天真 通知 特征 逃走 挑战
vb	耳边 岸边 案板 欧版 阿贝 阿扁 二八 二百 爱不 安保 二班
vc	暗藏 二层 爱车 暗处 按此 暗忖 耳垂 爱吃 哀愁 恩赐 恶臭
vd	耳朵 二队 殴打 爱得 阿呆 安定 二代 而定 额度 额定 黯淡
vf	案犯 安防 安抚 而返 二幅 暗访 二份 爱抚 案发 安放 二房
vg	而过 二姑 爱过 鞍钢 爱国 而该 俄国 昂贵 二哥 恶搞 耳光
vh	而后 爱好 爱护 安徽 暗黑 爱恨 懊悔 恶化 二号 耳环 二胡
vj	案件 二级 耳机 阿胶 暗叫 而将 而今 安静 按键 埃及 按揭
vk	安康 耳孔 阿克 儿科 爱卡 尔康 埃克 爱看 阿卡 爱哭 艾克
vl	而来 饿了 二楼 案例 恶劣 暗恋 二路 爱恋 阿拉 挨了 按了
vm	澳门 鞍马 噩梦 奥秘 欧盟 欧美 偶们 恶魔 按摩 暧昧 傲慢
vn	儿女 安妮 按扭 按钮 耳内 安宁 而能 安娜 懊恼 二奶 二女
vp	安排 鞍辔 安培 矮胖 耳畔 阿婆 爱普 耳旁 欧赔 二炮 奥普
vq	而且 鹅群 哀求 二千 暗器 爱情 傲气 二期 案情 二区 按期
vr	爱人 鹅绒 阿荣 偶然 鹅肉 爱染 恶人 愕然 黯然 而入 矮人
vs	昂首 盎司 二十 暗算 爱上 二室 暗杀 暗示 按时 而死 鞍山
vt	儿童 爱她 二厅 而逃 呕吐 额头 安泰 凹凸 而退 爱听 暗叹
vv	暗暗 媕娿 偶而 偶尔 恩恩 哀哀 嗷嗷 恩爱 啊啊 嗯嗯 爱爱
vw	安危 安慰 二万 额外 澳网 爱问 爱玩 二位 安稳 而亡 耳闻
vx	恶心 凹陷 按下 偶像 矮小 爱心 爱惜 而行 恶性 安详 翱翔
vy	而已 欧阳 奥运 安逸 哎呀 遨游 阿姨 而言 恶意 而又 欧元
vz	儿子 案子 挨揍 按住 按照 欧洲 而这 安装 安置 艾滋 澳洲
wb	无比 尾巴 外表 五笔 晚辈 未必 为本 文本 网吧 完毕 务必
wc	完成 挖出 维持 无处 晚餐 未曾 往常 午餐 王朝 外传 无耻
wd	问道 误导 伟大 无敌 万吨 稳定 舞蹈 味道 屋顶 温度 文档
wf	无法 无缝 潍坊 万分 雾峰 违法 微风 王府 违反 晚饭 往返
wg	我国 外观 无辜 五个 王国 无关 万股 外挂 武功 违规 网管
wh	文化 未婚 维护 为何 挽回 武汉 外汇 往后 误会 温和 危害
wj	文件 未经 危机 五金 玩具 忘记 挖掘 外交 玩家 网际 外界
wk	我看 微孔 外壳 外科 网卡 悟空 唯恐 胃口 文科 文库 为空
wl	为了 网络 未来 为例 网路 无论 物流 完了 威力 无聊 往来
wm	我们 网民 帷幕 未免 文明 完美 唯美 外贸 网名 妩媚 闻名
wn	无奈 未能 玩弄 五年 温暖 污泥 无能 为难 万能 万年 屋内
wp	物品 顽皮 外拍 文凭 外频 外婆 无盘 王牌 外篇 外屏 委派
wq	完全 委屈 为其 温泉 武器 无情 万千 舞曲 网球 误区 无穷
wr	温柔 围绕 微软 万人 往日 污染 五人 侮辱 宛如 微弱 文人
ws	晚上 文书 武士 卫生 网上 完善 往事 无数 为首 卧室 无声
wt	问题 舞台 委托 物体 无图 外滩 五天 网通 外套 问她 文体
wv	我爱 翁媪 无碍 为爱 巍峨 文案 娃儿 玩儿 味儿 玩偶 胃癌
ww	微微 娃娃 玩玩 往往 呜呜 问问 外围 文物 威望 万物 往外
wx	微笑 危险 文献 威胁 卫星 文学 无需 无限 无形 维修 温馨
wy	唯一 无缘 万一 无疑 委员 网游 网页 文艺 王爷 位于 万元
wz	位置 屋子 完整 握住 为止 文章 武装 物质 为主 文字 王子
xb	宣布 下巴 相比 雪白 性别 西部 下班 想必 细胞 新版 西北
xc	形成 现出 现场 宣传 寻常 相差 写出 相处 消除 相册 行程
xd	许多 相对 想到 显得 相当 兄弟 穴道 行动 现代 晓得 小弟
xf	幸福 消费 兴奋 相反 小幅 想法 消防 西方 媳妇 修复 先锋
xg	香港 修改 性格 相公 效果 习惯 下岗 相关 性感 选购 像个
xh	喜欢 小孩 相互 先后 信号 下滑 型号 协会 学会 幸好 循环
xj	小姐 下降 先进 现金 相见 选举 相机 袭击 相继 新疆 细节
xk	胸口 姓孔 辛苦 学科 显卡 星空 小康 许可 新款 新开 侠客
xl	下来 训练 心理 旋律 线路 效率 行李 醒来 向来 心灵 下落
xm	项目 兄妹 羡慕 性命 鲜明 厦门 熊猫 姓名 消灭 小麦 西门
xn	性能 新娘 虚拟 新年 校内 西宁 效能 西南 信念 细腻 想念
xp	新品 橡皮 选票 芯片 吓跑 夏普 洗牌 相片 新片 胸脯 宣判
xq	想起 先驱 兴趣 香气 镶嵌 心情 小区 向前 需求 先前 星期
xr	显然 虚弱 羞辱 信任 昔日 笑容 夏日 陷入 行人 形容 新人
xs	先生 吸收 迅速 学生 小时 现实 享受 形式 形势 消失 显示
xt	系统 向她 夏天 胸膛 相同 协调 小偷 心跳 心态 形态 心痛
xv	喜爱 狭隘 邪恶 性爱 西岸 西安 险恶 相爱 限额 小额 西欧
xw	希望 纤维 虚无 下午 香味 行为 想问 新闻 询问 学位 向往
xx	相信 学习 学校 信息 星星 谢谢 信心 消息 休息 现象 形象
xy	需要 吸引 小雨 信用 校园 协议 学院 效益 相应 喜悦 现有
xz	现在 仙子 选择 乡镇 协助 向着 学者 行政 寻找 小组 限制
yb	一般 邮编 要不 以便 一步 一半 一本 原本 拥抱 已被 一遍
yc	因此 演出 隐藏 远处 异常 预测 远程 由此 衣裳 原创 一场
yd	一定 引导 遇到 一代 一点 印度 一动 有点 应当 一旦 运动
yf	衣服 越发 一副 一番 一幅 依法 预防 应付 月份 一份 研发
yg	应该 勇敢 严格 一股 眼光 有关 员工 英国 阳光 月光 缘故
yh	以后 友好 疑惑 银行 隐患 用户 优惠 一行 议会 优化 遗憾
yj	已经 业绩 迎接 以及 眼睛 研究 依据 要紧 依旧 引进 遇见
yk	一块 圆孔 一款 依靠 一颗 愉快 一棵 一刻 游客 有空 遥控
yl	原来 压力 以来 娱乐 一路 眼泪 严厉 原谅 医疗 一流 一连
ym	一面 移民 迎面 以免 幽默 阴谋 玉米 要命 页面 域名 郁闷
yn	一年 也能 云南 意念 以内 旖旎 酝酿 越南 又能 业内 印尼
yp	一旁 荧屏 一批 影片 药品 一派 样品 硬盘 音频 一篇 应聘
yq	一切 一群 要求 语气 仪器 以前 勇气 尤其 引起 一齐 邀请
yr	依然 犹如 炎热 引入 羊肉 要让 友人 艺人 诱人 已然 游人
ys	也是 严肃 艺术 一身 于是 意识 有所 意思 要是 一时 以上
yt	摇头 一台 一套 一条 一听 丫头 一跳 用途 一团 液体 烟台
yv	因而 要隘 悦耳 婴儿 阴暗 议案 鱼儿 幼儿 预案 余额 延安
yw	因为 鱼尾 一万 业务 夜晚 以为 义务 以外 要闻 以往 愿望
yx	一些 有限 英雄 一向 有些 也许 以下 影响 有效 运行 优秀
yy	一样 医院 由于 应用 原因 愿意 远远 永远 意义 语言 拥有
yz	一直 一阵 一致 严重 原则 亚洲 沿着 样子 银子 椅子 影子
zb	准备 嘴巴 再不 装备 逐步 转变 主板 这边 资本 指标 主办
zc	支持 指出 造成 政策 正常 再次 嘴唇 作出 组成 做出 资产
zd	知道 指导 找到 只得 重点 制度 自动 直到 重大 值得 制定
zf	政府 总发 丈夫 作风 涨幅 执法 字符 做法 住房 支付 祝福
zg	这个 整改 职工 整个 祖国 最高 足够 照顾 走过 中共 总管
zh	之后 只好 指挥 最后 招呼 珠海 中华 最好 综合 做好 转换
zj	自己 增加 直接 资金 只见 之间 逐渐 之际 专家 中间 最近
zk	召开 针孔 展开 专科 张口 状况 周刊 张开 最快 这款 折扣
zl	这里 走了 总理 专利 质量 资料 整理 战略 治理 长老 治疗
zm	怎么 皱眉 字幕 这么 证明 专门 知名 咱们 著名 折磨 桌面
zn	只能 职能 指南 周年 之内 支农 怎能 智能 站内 子女 灾难
zp	只怕 诈骗 招聘 照片 作品 最怕 招牌 制品 自拍 这篇 栽培
zq	之前 增强 正确 赚钱 作曲 证券 抓起 追求 争取 准确 主权
zr	自然 诸如 最热 众人 昨日 转让 纵然 主人 责任 主任 真人
zs	只是 证书 正式 转身 真是 知识 重视 这时 再说 总是 至少
zt	总统 这台 状态 整体 主题 增添 整天 昨天 主体 专题 总体
zv	这儿 祝阿 障碍 做爱 之恩 治安 作案 总额 阻碍 罪恶 周二
zw	作为 皱纹 掌握 之外 周围 中文 暂无 诸位 中午 昨晚 职务
zx	这些 仔细 之下 执行 最小 主席 秩序 坐下 走向 转向 政协
zy	这样 早已 只有 作用 中央 注意 怎样 重要 只要 主要 终于
zz	正在 组织 真正 增长 之中 政治 阻止 抓住 作者 战争 挣扎